██████████████████████████████████
█▒▒▒▒▒▒▒▒▒▒▒▒▒▒▒▒▒▒▒▒▒▒▒▒▒▒▒▒▒▒▒▒█
█   ██████  ███  ████ ███████   ▒█
█                               ▒█
█                               ▒█
█ ☺     ▒         ▒             ▒█
███                          ░  ▒█
█         ▒                     ▒█
█                               ▒█
█    ▒                 ▒        ▒█
█                               ▒█
█                               ▒█
█    ███████  ███  █████  ███   ▒█
█▒▒▒▒▒▒▒▒▒▒▒▒▒▒▒▒▒▒▒▒▒▒▒▒▒▒▒▒▒▒▒▒█
██████████████████████████████████