██████████████████████████████████
█▒▒▒▒▒▒█▒▒▒▒▒▒▒▒▒▒▒▒▒▒▒▒▒▒▒▒▒▒▒▒▒█
█     ▒█▒▒███████    ██         ▒█
█     ▒█▒▒░                     ▒█
█     ▒█▒▒▒▒▒▒▒▒██████          ▒█
█ ☺   ▒█████████████▒           ▒█
███   ▒▒▒▒▒▒▒▒▒▒▒▒▒▒▒           ▒█
█    ███████  █████             ▒█
█                               ▒█
█                               ▒█
█                               ▒█
█                               ▒█
█   ██     ████   ███████       ▒█
█▒▒▒▒▒▒▒▒▒▒▒▒▒▒▒▒▒▒▒▒▒▒▒▒▒▒▒▒▒▒▒▒█
██████████████████████████████████